####################
#   #      #      .#
# $ # $$$$ # $$$  .#
#   #      #      .#
### ###### #########
#                  #
# $$ $$$$ $$$$$ $$ #
#                  #
####### ############
#@                 #
# $$$ $$$ $$$$$ $$ #
#                  #
####### ############
#                  #
# $$ $$$$ $$$$$ $$ #
#                  #
### ###### #########
#   #      #      .#
# $ # $$$$ # $$$  .#
#   #      #      .#
####################