##########
#        #
#  $  .  #
#  @     #
#        #
##########