############
#    #     #
#    # $.  #
#    #     #
#  @ #     #
#          #
#          #
############