############
#    #     #
# $  # $.  #
#          #
#    #  .  #
#  @ #     #
#          #
############