#############
#   ##      #
# $  #  $.  #
#    #   .  #
#           #
#  @ ##     #
#     #     #
#############