##############
#     #      #
#            #
#   $ #  ..  #
#   @ #      #
#     ##     #
#   $       ##
#    #       #
##############