##########
#   #    #
# $ #    #
#   #    #
#     .  #
#@  ######
#   . .  #
# $ #  $ #
#        #
#   #    #
#   #    #
##########