############
#  #     # #
# $.$  # $ #
#  #     # #
## ####### #
#    @     #
# ## ### ###
# $ #   #$ #
# .#   #. #
#  #   #  #
#  #   #  #
############