##############
#............#
#.##########.#
#.#        #.#
#.# $$ $$  #.#
#.#        #.#
#.#   ##   #.#
#.#   ##   #.#
#.#        #.#
#.#  $$ $$ #.#
#.#        #.#
#.##########.#
#............#
##############