################
#   #     #    #
# $ # $$$ #  $ #
#   #     #    #
### ####### ####
#@            .#
# ### ### ###  #
# $   #   #  $ #
# ### # ### ####
#   .#   #    #
##### ### ######
#    #   #    #
# $$$# $$$# $ #
#    #     #  #
#            .#
################